А.Р.Е.С.	c	А.Р.Е.С.
Аберрация	a	аберрацию
Аннабель	a	Аннабель
Архонт	a	архонта
Бронетранспортер колонистов	a	бронетранспортер колонистов
Артанис	a	Артаниса
Артефакт	a	артефакт
Фрагмент артефакта	a	фрагмент артефакта
Хранилище артефакта	a	хранилище артефакта
Ассимилятор	a	ассимилятор
Лазерная батарея «воздух-воздух»	a	лазерную батарею «воздух-воздух»
Лазерная батарея «воздух-земля»	a	лазерную батарею «воздух-земля»
Атакующий	a	атакующего
Автоматический компрессор	a	автоматический компрессор
Автоматон-2000	a	Автоматон-2000
Автотурель	a	автотурель
Доступная ядерная ракета	a	доступную ядерную ракету
Ракеты «Бумеранг»	a	ракеты «Бумеранг»
Гиблинг	a	гиблинга
Кокон гиблинга	a	кокон гиблинга
Гнездо гиблингов	a	гнездо гиблингов
Бралик	a	Бралика
Хозяин стаи	a	хозяина стаи
Симбионт	a	симбионта
Брат Тош	a	брата Тоша
Бруталиск	a	бруталиска
Банни Лебовски	a	Банни Лебовски
Кейд	a	Кейда
Грузовик	a	грузовик
Авианосец	a	авианосец
Мимикрид	a	мимикрида
Нетупырь	a	нетупыря
Хризалида	a	хризалиду
Мирный житель	a	мирного жителя
Колонист	a	колониста
Колосс	a	колосса
Купер	a	Купера
Губитель	a	губителя
Корова	a	корову
Грузовик «Упрямый осел»	a	грузовик «Упрямый осел»
Существо	a	существо
Байк	a	байк
Темный тамплиер	a	темного тамплиера
Адский Пес	a	наемника из «Адских Псов»
Пожиратель	a	пожирателя
Диабло, Повелитель Ужаса	a	Диабло, Повелителя Ужаса
Аспид	a	«Аспид»
Собака	a	собаку
Д-р Ариэль Хэнсон – д-р мед. д-р фил.	a	д-ра Ариэль Хэнсон – д-ра мед. д-р фил.
Драгун	a	«Драгуна»
Рабочий	a	рабочего
Самосвал	a	самосвал
Сумрачная стая	a	наемника из «Сумрачной стаи»
Голландец	a	Голландца
Эрл	a	Эрла
Игон Стетманн	a	Игона Стетманна
Поедатель	a	поедателя
Самка карака	a	самку карака
Самка медведня	a	самку медведня
Огнеметчик	a	огнеметчика
Грузовик-платформа	a	грузовик-платформу
Габриэль Тош	a	Габриэля Тоша
Призрак	a	призрака
Копьезмейка	a	копьезмейку
Голиаф	a	«Голиафа»
Гренадер	a	гренадера
Страж	a	стража
Холл	a	Холл
Топ-секьюрити	a	Топ-секьюрити
Хэнсон	a	Хэнсон
Гелиос	a	Гелиос
Геллион	a	«Геллион»
Ангел Аида	a	наемника из «Ангелов Аида»
Геркулес	a	«Геркулес»
Герой А	a	героя А
Герой B	a	героя B
Герой C	a	героя C
Высший тамплиер	a	высшего тамплиера
Хилл	a	Хилла
Охотник-убийца	a	охотника-убийцу
Гибрид	a	гибрида
Гибрид-разрушитель	a	гибрида-разрушителя
Гибрид-опустошитель	a	гибрида-опустошителя
ГибридC	a	гибридаC
ГибридD	a	гибридаD
Гидралиск	a	гидралиска
Бессмертный	a	бессмертного
Зараженный морпех	a	зараженного морпеха
Зараженный терран	a	зараженного террана
Заразитель	a	заразителя
Перехватчик	a	перехватчик
Джим Рейнор	a	Джима Рейнора
Качински	a	Качински
Карасс	a	Карасса
Керриган	a	Керриган
Хризалида Керриган	a	хризалиду Керриган
L2 «Скороход»	a	L2 «Скороход»
Лаб Адъютант	a	адъютанта
Личинка	a	личинку
Лавовый краб	a	лавового краба
Левиафан	a	Левиафана
Локи	a	«Локи»
Скрытень	a	скрытня
Кокон скрытня	a	кокон скрытня
Лиот	a	лиота
Маар	a	Маара
Самец карака	a	самца карака
Самец медведака	a	самца медведака
Мародер	a	мародера
Морпех	a	морпеха
Мэтт Хорнер	a	Мэтта Хорнера
Медик	a	медика
Медэвак	a	медэвака
Шахтер	a	шахтера
Моэндар	a	Моэндара
Монолит	a	Монолит
МУЛ	a	МУЛ
Мурлок-морпех	a	мурлока-морпеха
Муталиск	a	муталиска
Невральный паразит	a	неврального паразита
Нова	a	Нову
Червь Нидуса	a	червя Нидуса
Наблюдатель	a	наблюдателя
«Один»	a	«Одина»
Омегалиск	a	омегалиска
Купе «Орион Турбо»	a	Купе «Орион Турбо»
Надзиратель	a	надзирателя
Владыка	a	владыку
Феникс	a	«Феникс»
Портовый мусорщик	a	портовый мусорщик
Хищник	a	Хищника
Хранитель	a	Хранителя
Заключенный	a	заключенного
Зонд	a	зонд
Пропагандистский стенд	a	Пропагандистский стенд
Реликвия протоссов	a	реликвию протоссов
Пси-разрушитель	a	пси-разрушитель
Пси-излучатель	a	пси-излучатель
Пигалиск	a	пигалиска
Королева	a	королеву
Королева Клинков	a	Королеву Клинков
Ворон	a	«Ворона»
Рейнор	a	Рейнора
Головорез	a	головореза
Таракан	a	таракана
Рори Свонн	a	Рори Свонна
Сколопендра	a	сколопендру
Скарабей	a	скарабея
Ученый	a	ученого
Слепень	a	слепня
Разведчик	a	разведчика
КСМ	a	КСМ
Селендис	a	Селендис
Часовой	a	часового
Теневой клон	a	теневой клон
Овца	a	овцу
Городское купе	a	городское купе
Мастер осады	a	наемника из «Мастеров осады»
Осадный танк	a	осадный танк
Источник душ	a	источник душ
Отряд спартанцев	a	наемника из «Отряда спартанцев»
Фантом	a	фантома
Ползучий плеточник	a	ползучего плеточника
Ползучий споровик	a	ползучего споровика
Сталкер	a	сталкера
Стетманн	a	Стетманна
Каменный зилот	a	каменного зилота
Свонн	a	Свонна
Малек роя	a	малька роя
Танк	a	танк
Автоцистерна	a	автоцистерну
Тассадар	a	Тассадара
Таурен-космодесантник	a	таурена-космодесантника
Волки Корхала	a	наемника из «Волков Корхала»
Тор	a	«Тора»
Обломки «Тора»	a	Обломки «Тора»
Шипастая рептилия	a	шипастую рептилию
Тош	a	Тоша
Триллик	a	Триллика
Бронетранспортер	a	бронетранспортер
Тайкус	a	Тайкуса
Тайкус Финдли	a	Тайкуса Финдли
Ультралиск	a	ультралиска
Детеныш медведня	a	детеныша медведня
Урубу	a	Урубу
Урун	a	Уруна
Валериан Менгск	a	Валериана Менгска
Вирофаг	a	вирофага
Стервятник	a	«Стервятника»
Боевые кабаны	a	наемника из «Боевых кабанов»
Ворфилд	a	Ворфилда
Йа-гуана	a	йа-гуану
Ибарра	a	Ибарру
Зилот	a	зилота
Зератул	a	Зератула
Тень Зератула	a	тень Зератула
Зерглинг	a	зерглинга
реклама PsiOps	c	реклама PsiOps
«Один»	c	«Один»
250-мм орудия	c	250-мм орудия
330-мм орудие	c	330-мм орудие
330-мм орудия	c	330-мм орудия
Аберрация	c	аберрация
Автоматический ремонт	c	автоматический ремонт
Автоцистерна	c	автоцистерна
Адские псы	c	Адские псы
Адский пес	c	Адский пес
Академия призраков	c	академия призраков
Академия фантомов	c	академия фантомов
Активация	c	активация
Ангар	c	ангар
Ангар хозяина стаи	c	ангар хозяина стаи
Ангел Аида	c	Ангел Аида
Ангелы Аида	c	Ангелы Аида
Аптечка	c	аптечка
Арктур Менгск	c	Арктур Менгск
Арсенал	c	арсенал
Артанис	c	Артанис
Артобстрел	c	артобстрел
Архив	c	архив
Архив заданий	c	архив заданий
Архивы тамплиеров	c	архивы тамплиеров
Архонт	c	архонт
Аспид	c	аспид
Атака	c	атака
Атаковать	c	атаковать
Атаковать строение	c	атаковать строение
Атакующий	c	атакующий
Аэростат	c	аэростат
Бак с терразином	c	бак с терразином
Баллистические ускорители	c	баллистические ускорители
Банши	c	банши
Башня зел-нага	c	башня зел-нага
Берлога гидралисков	c	берлога гидралисков
Берлога скрытней	c	берлога скрытней
Бессмертный	c	бессмертный
Бешенство	c	бешенство
Биокупол	c	биокупол
Биокупол колонистов	c	биокупол колонистов
Биоплазмидный разряд	c	биоплазмидный разряд
Биостазис	c	биостазис
Блок B	c	Блок B
Блокпост	c	блокпост
Богатое месторождение	c	богатое месторождение
Богатый веспеновый гейзер	c	богатый веспеновый гейзер
Боевая система класса «Фобос»	c	боевая система класса «Фобос»
Боевой щит	c	боевой щит
Боевые кабаны	c	Боевые кабаны
Большое окно	c	большое окно
Бочка с токсичным газом	c	бочка с токсичным газом
Бралик	c	Бралик
Брат Тош	c	брат Тош
Броня «Сделай сам»	c	броня «Сделай сам»
Бросить гранату	c	бросить гранату
Бросить сферы Пустоты	c	бросить сферы Пустоты
Бруталиск	c	бруталиск
Бункер	c	бункер
Бункер из неостали	c	бункер из неостали
Быстрая высадка	c	быстрая высадка
Быстрая регенерация	c	быстрая регенерация
Быстрое перемещение войск по тоннелю червя Нидуса	c	быстрое перемещение войск по тоннелю червя Нидуса
Быстрое переоборудование в планетарную крепость	c	быстрое переоборудование в планетарную крепость
Валериан Менгск	c	Валериан Менгск
Вездеход «Могикан»	c	вездеход «Могикан»
Вертикальный блокпост	c	вертикальный блокпост
Веспеновый гейзер	c	веспеновый гейзер
Взлететь	c	взлететь
Взорвать строение	c	взорвать строение
Взрыв	c	взрыв
Взрыв мозга	c	взрыв мозга
Взрыв сферы Пустоты	c	взрыв сферы Пустоты
Взрыв фазовой мины	c	взрыв фазовой мины
Взрывчатка	c	взрывчатка
Взрывчатка D8	c	взрывчатка D8
Взрывчатка G-4	c	взрывчатка G-4
Взять особый объект	c	взять особый объект
Взять хризалиду	c	взять хризалиду
Викинг	c	викинг
Винтовка	c	винтовка
Вирофаг	c	вирофаг
Вкл. легкий мост	c	вкл. легкий мост
Включить легкий мост	c	включить легкий мост
Владыка	c	владыка
Внешняя стена	c	внешняя стена
Внутренний взрыв	c	внутренний взрыв
Воздаятель	c	Воздаятель
Возмездие Джексона	c	Возмездие Джексона
Возмещение	c	возмещение
Волки Корхала	c	Волки Корхала
Волна плазмы	c	волна плазмы
Вооружиться огнеметом	c	вооружиться огнеметом
Вооружиться плазменной винтовкой	c	вооружиться плазменной винтовкой
Вооружиться табельной штурмовой винтовкой	c	вооружиться табельной штурмовой винтовкой
Вооружиться шестиствольным пулеметом	c	вооружиться шестиствольным пулеметом
Ворон	c	ворон
Воронка	c	воронка
Ворота	c	ворота
Ворфилд	c	Ворфилд
Восстанавливающий заряд	c	восстанавливающий заряд
Врата	c	врата
Врата искривления	c	врата искривления
Врата храма зел-нага	c	врата храма зел-нага
Временной разлом	c	временной разлом
Вспышка	c	вспышка
Вход в тюрьму	c	вход в тюрьму
Выбрать личинок	c	выбрать личинок
Выбрать строителя	c	выбрать строителя
Выброс автотурели	c	выброс автотурели
Выброс модуля точечной обороны	c	выброс модуля точечной обороны
Выгрузить	c	выгрузить
Выгрузить всех	c	выгрузить всех
Выгрузить ресурсы	c	выгрузить ресурсы
Вызвать авианосец	c	вызвать авианосец
Вызвать архивы тамплиеров	c	вызвать архивы тамплиеров
Вызвать архонта	c	вызвать архонта
Вызвать ассимилятор	c	вызвать ассимилятор
Вызвать бессмертного	c	вызвать бессмертного
Вызвать врата	c	вызвать врата
Вызвать высшего тамплиера	c	вызвать высшего тамплиера
Вызвать дополнительное строение	c	вызвать дополнительное строение
Вызвать драгуна	c	вызвать драгуна
Вызвать завод робототехники	c	вызвать завод робототехники
Вызвать звездные врата	c	вызвать звездные врата
Вызвать Зератула	c	вызвать Зератула
Вызвать зилота	c	вызвать зилота
Вызвать зонд	c	вызвать зонд
Вызвать излучатель Пустоты	c	вызвать излучатель Пустоты
Вызвать кибернетическое ядро	c	вызвать кибернетическое ядро
Вызвать ключевое строение	c	вызвать ключевое строение
Вызвать колосса	c	вызвать колосса
Вызвать материнский корабль	c	вызвать материнский корабль
Вызвать маяк флотилии	c	вызвать маяк флотилии
Вызвать Моэндара	c	вызвать Моэндара
Вызвать наблюдатель	c	вызвать наблюдатель
Вызвать наемников	c	вызвать наемников
Вызвать нексус	c	вызвать нексус
Вызвать оружейную	c	вызвать оружейную
Вызвать пилон	c	вызвать пилон
Вызвать призму искривления	c	вызвать призму искривления
Вызвать разведчик	c	вызвать разведчик
Вызвать робототехнический узел	c	вызвать робототехнический узел
Вызвать Селендис	c	вызвать Селендис
Вызвать сталкера	c	вызвать сталкера
Вызвать строение	c	вызвать строение
Вызвать сумеречный совет	c	вызвать сумеречный совет
Вызвать темного тамплиера	c	вызвать темного тамплиера
Вызвать темное святилище	c	вызвать темное святилище
Вызвать Уруна	c	вызвать Уруна
Вызвать феникса	c	вызвать феникса
Вызвать фотонную пушку	c	вызвать фотонную пушку
Вызвать часового	c	вызвать часового
Вызов материнского корабля	c	вызов материнского корабля
Вызов хранилища	c	вызов хранилища
Вызывается	c	вызывается
Выкапывание	c	выкапывание
Выкапывание дозорного орудия	c	выкапывание дозорного орудия
Выкопать турель	c	выкопать турель
Выкопаться	c	выкопаться
Вырабатывать слизь	c	вырабатывать слизь
Выработка слизи	c	выработка слизи
Выстрел из спорового орудия	c	выстрел из спорового орудия
Выстрел патроном «Игла»	c	выстрел патроном «Игла»
Высший тамплиер	c	высший тамплиер
Габриэль Тош	c	Габриэль Тош
Газ	c	газ
Гараж	c	гараж
Геллион	c	геллион
Генератор временного разлома	c	генератор временного разлома
Генератор гравитонного поля	c	генератор гравитонного поля
Геркулес	c	Геркулес
Герой B	c	герой B
Герой C	c	герой C
Герой А	c	герой А
Гиблинг	c	гиблинг
Гибрид	c	гибрид
ГибридC	c	гибридC
ГибридD	c	гибридD
Гибрид-опустошитель	c	гибрид-опустошитель
Гибрид-разрушитель	c	гибрид-разрушитель
Гидралиск	c	гидралиск
Гиперион	c	Гиперион
Гиперфлюксор	c	гиперфлюксор
Главный тюремный блок	c	главный тюремный блок
Глазные импланты	c	глазные импланты
Глубинный туннель	c	глубинный туннель
Голиаф	c	Голиаф
Голландец	c	голландец
Головорез	c	головорез
Голограмма адъютанта	c	голограмма адъютанта
Голограмма Арктура	c	голограмма Арктура
Голографический стенд Доминиона	c	голографический стенд Доминиона
Гравитонная тюрьма	c	гравитонная тюрьма
Гравитонные бомбы	c	гравитонные бомбы
Гравитонный луч	c	гравитонный луч
Гранаты	c	гранаты
Гранаты «Каратель»	c	гранаты «Каратель»
Гренадер	c	гренадер
Груда металлолома	c	груда металлолома
Груз минералов	c	груз минералов
Груз минералов<sp/>	c	груз минералов<sp/>
Грузовик-платформа	c	грузовик-платформа
Губитель	c	губитель
Дальнобойные ракеты	c	дальнобойные ракеты
Дар свободы	c	Дар свободы
двигаться	c	двигаться
Двигаться в поиске цели	c	двигаться в поиске цели
Двигаться в режиме наблюдения	c	двигаться в режиме наблюдения
Двигаться, удерживая позицию	c	двигаться, удерживая позицию
Движение	c	движение
Двойной лечебный луч	c	двойной лечебный луч
Действие пси-аннулятора	c	действие пси-аннулятора
Демаскировка	c	демаскировка
Демонтаж	c	демонтаж
Демонтировать	c	демонтировать
Дерево	c	дерево
Десантная капсула	c	десантная капсула
Десантный корабль	c	десантный корабль
Десантный корабль спецназа	c	десантный корабль спецназа
Детектор	c	детектор
Детеныш медведня	c	детеныш медведня
Джим Рейнор	c	Джим Рейнор
Диабло, Повелитель Ужаса	c	Диабло, Повелитель Ужаса
Дистанционный подрыв	c	дистанционный подрыв
Добывать	c	добывать
Дозорное орудие	c	дозорное орудие
Дом	c	дом
Дом колонистов	c	дом колонистов
Доминионская статуя	c	доминионская статуя
Дополнительное оборудование	c	дополнительное оборудование
Доступные ядерные ракеты	c	доступные ядерные ракеты
Драгун	c	Драгун
Заброшенное строение	c	заброшенное строение
Завод	c	завод
Завод робототехники	c	завод робототехники
Загон	c	загон
Загрузить	c	загрузить
Задать дополнительную точку сбора	c	задать дополнительную точку сбора
Задать точку сбора	c	задать точку сбора
Задать точку сбора для бункера	c	задать точку сбора для бункера
Задать точку сбора для рабочих	c	задать точку сбора для рабочих
Закапывание	c	закапывание
Закапывание дозорного орудия	c	закапывание дозорного орудия
Закись пситрия	c	закись пситрия
Закись пситрия вкл	c	закись пситрия вкл
Закись пситрия выкл	c	закись пситрия выкл
Заключенный	c	заключенный
Закопаться	c	закопаться
Закрыть ворота	c	закрыть ворота
Заложить заряд промышленной взрывчатки	c	заложить заряд промышленной взрывчатки
Заложить паучьи мины	c	заложить паучьи мины
Залп плазмы	c	залп плазмы
Замаскировать мимикрида	c	замаскировать мимикрида
Замыкание	c	замыкание
Заначка Тайкуса	c	заначка Тайкуса
Запечатанный талдаримский алтарь	c	запечатанный талдаримский алтарь
Запечатано протоссами	c	запечатано протоссами
Запечатано терранами	c	запечатано терранами
Запечатать архив	c	запечатать архив
Запрос	c	запрос
Запрос: дополнительные припасы	c	запрос: дополнительные припасы
Запрос: МУЛ	c	запрос: МУЛ
Заражающий рой	c	заражающий рой
Заражение колонии	c	заражение колонии
Зараженная ракетная турель	c	зараженная ракетная турель
Зараженное хранилище	c	зараженное хранилище
Зараженные казармы	c	зараженные казармы
Зараженные терраны	c	зараженные терраны
Зараженный арсенал	c	зараженный арсенал
Зараженный бар	c	зараженный бар
Зараженный бункер	c	зараженный бункер
Зараженный завод	c	зараженный завод
Зараженный инженерный комплекс	c	зараженный инженерный комплекс
Зараженный командный центр	c	зараженный командный центр
Зараженный корабль колонистов	c	зараженный корабль колонистов
Зараженный космопорт	c	зараженный космопорт
Зараженный морпех	c	зараженный морпех
Зараженный перерабатывающий завод	c	зараженный перерабатывающий завод
Зараженный терран	c	зараженный терран
Заразитель	c	заразитель
Зародыши зараженных терранов	c	зародыши зараженных терранов
Заряд	c	заряд
Заряд временного разлома	c	заряд временного разлома
Заряды плазмы	c	заряды плазмы
Захват башни	c	захват башни
Защитная матрица	c	защитная матрица
Защитная стена	c	защитная стена
Звездная карта	c	звездная карта
Звездные врата	c	звездные врата
Здоровье +100	c	здоровье +100
Здоровье +25	c	здоровье +25
Здоровье +50	c	здоровье +50
Зератул	c	Зератул
Зерглинг	c	зерглинг
Зилот	c	зилот
Знак вопроса	c	знак вопроса
Ибарра	c	Ибарра
Игон Стетманн	c	Игон Стетманн
Идет строительство	c	идет строительство
Излучатель Пустоты	c	излучатель Пустоты
Иллюзия	c	иллюзия
Инерционный дестабилизатор	c	инерционный дестабилизатор
Инженерный комплекс	c	инженерный комплекс
Инкубатор	c	инкубатор
Интегрированные огнеметы	c	интегрированные огнеметы
Ионные пушки	c	ионные пушки
Искажающее поле	c	искажающее поле
Искатель Пустоты	c	Искатель Пустоты
Ископаемый терразин	c	ископаемый терразин
Искривление времени	c	искривление времени
Использовать стимуляторы	c	использовать стимуляторы
Исследовательская лаборатория	c	исследовательская лаборатория
Источник заражения	c	источник заражения
Истощение	c	истощение
Истребитель «Викинг»	c	истребитель «Викинг»
Йа-гуана	c	йа-гуана
Казармы	c	казармы
Каменный зилот	c	каменный зилот
Камера адъютанта	c	камера адъютанта
Канал души	c	канал души
Канистра с горючим	c	канистра с горючим
Канистра с терразином	c	канистра с терразином
Карасс	c	Карасс
Кассетные бомбы G-4	c	кассетные бомбы G-4
Кейд	c	Кейд
Кибернетическое ядро	c	кибернетическое ядро
Кислотная слюна	c	кислотная слюна
Кокон	c	кокон
Кокон владыки	c	кокон владыки
Кокон заражения	c	кокон заражения
Кокон зергов	c	кокон зергов
Кокон муталиска	c	кокон муталиска
Кокон пигалиска	c	кокон пигалиска
Колонист	c	колонист
Колосс	c	колосс
Командный центр	c	командный центр
Конец осады	c	конец осады
Консоль в талдаримской темнице	c	консоль в талдаримской темнице
Контейнер с газом	c	контейнер с газом
Контейнер с минералами	c	контейнер с минералами
Конус	c	конус
Копьезмейка	c	копьезмейка
Корабль колонистов	c	корабль колонистов
Корни зергов	c	корни зергов
Корова	c	корова
Королева	c	королева
Королева Клинков	c	королева клинков
Космопорт	c	космопорт
Костюм «Криос»	c	костюм «криос»
Костяные иглы	c	костяные иглы
Крейсер	c	крейсер
Кристалл талдаримской темницы	c	кристалл талдаримской темницы
Кристаллы газа	c	кристаллы газа
Кротовая нора	c	кротовая нора
Куб	c	куб
Купер	c	Купер
Лаб Адъютант	c	Лаб Адъютант
Лаборатория	c	лаборатория
Лабораторный реактор	c	лабораторный реактор
Лавовый краб	c	лавовый краб
Лазер точечной обороны	c	лазер точечной обороны
Лазерная батарея «воздух»-«воздух»	c	лазерная батарея «воздух»-«воздух»
Лазерная батарея «воздух»-«земля»	c	лазерная батарея «воздух»-«земля»
Лазерная установка	c	лазерная установка
Левиафан	c	Левиафан
Лечение	c	лечение
Лиот	c	лиот
Личинка	c	личинка
Личная маскировка	c	личная маскировка
Ловушка вуду	c	ловушка вуду
Логово	c	логово
Локи	c	Локи
Луч силового поля	c	луч силового поля
Маар	c	маар
Малек роя	c	малек роя
Мародер	c	мародер
Маскировка	c	маскировка
Маскировка под зерга без крыльев	c	маскировка под зерга без крыльев
Маскировка под зерга с крыльями	c	маскировка под зерга с крыльями
Маскировочное поле	c	маскировочное поле
Маскировочный модуль «Никта»	c	маскировочный модуль «Никта»
Массовая телепортация	c	массовая телепортация
Массовое убийство	c	массовое убийство
Мастер осады	c	мастер осады
Мастера осады	c	мастера осады
Материнский корабль	c	материнский корабль
Маяк	c	маяк
Маяк сброса дополнительных припасов	c	маяк сброса дополнительных припасов
Маяк флотилии	c	маяк флотилии
Маячок обнаружения	c	маячок обнаружения
Медик	c	медик
Медэвак	c	медэвак
Мерзкий поток	c	мерзкий поток
Месторождение минералов	c	месторождение минералов
Металлолом	c	металлолом
Мешки с песком	c	мешки с песком
Микоз	c	микоз
Мимикрид	c	мимикрид
Мимикрия	c	мимикрия
Мимикрия под зилота	c	мимикрия под зилота
Мимикрия под морпеха без щита	c	мимикрия под морпеха без щита
Мимикрия под морпеха со щитом	c	мимикрия под морпеха со щитом
Мина «Цербер»	c	мина «Цербер»
Мины	c	мины
Мираж	c	Мираж
Мирный житель	c	мирный житель
Множественное наведение	c	множественное наведение
Модуль точечной обороны	c	модуль точечной обороны
Можно объединить	c	можно объединить
Морпех	c	морпех
Морпех 03	c	морпех 03
Морпех 04	c	морпех 04
Моэндар	c	Моэндар
Мурлок-морпех	c	мурлок-морпех
Муталиск	c	муталиск
Мутировать в берлогу гидралисков	c	мутировать в берлогу гидралисков
Мутировать в вирофага	c	мутировать в вирофага
Мутировать в гиблинга	c	мутировать в гиблинга
Мутировать в гидралиска	c	мутировать в гидралиска
Мутировать в гнездо гиблингов	c	мутировать в гнездо гиблингов
Мутировать в губителя	c	мутировать в губителя
Мутировать в зараженного мирного жителя	c	мутировать в зараженного мирного жителя
Мутировать в заразителя	c	мутировать в заразителя
Мутировать в зерглинга	c	мутировать в зерглинга
Мутировать в инкубатор	c	мутировать в инкубатор
Мутировать в логово	c	мутировать в логово
Мутировать в муталиска	c	мутировать в муталиска
Мутировать в надзирателя	c	мутировать в надзирателя
Мутировать в омут рождения	c	мутировать в омут рождения
Мутировать в эволюционную камеру	c	мутировать в эволюционную камеру
Мутировать в пещеру ультралисков	c	мутировать в пещеру ультралисков
Мутировать в ползучего плеточника	c	мутировать в ползучего плеточника
Мутировать в ползучего споровика	c	мутировать в ползучего споровика
Мутировать в рабочего	c	мутировать в рабочего
Мутировать в рассадник тараканов	c	мутировать в рассадник тараканов
Мутировать в сеть Нидуса	c	мутировать в сеть Нидуса
Мутировать в симбионта	c	мутировать в симбионта
Мутировать в скрытня	c	мутировать в скрытня
Мутировать в слепня	c	мутировать в слепня
Мутировать в таракана	c	мутировать в таракана
Мутировать в улей	c	мутировать в улей
Мутировать в ультралиска	c	мутировать в ультралиска
Мутировать в хозяина стаи	c	мутировать в хозяина стаи
Мутировать в червя Нидуса	c	мутировать в червя Нидуса
Мутировать в шпиль	c	мутировать в шпиль
Мутировать в шпиль величия	c	мутировать в шпиль величия
Мутировать в экстрактор	c	мутировать в экстрактор
Мутировать в яму заразителей	c	мутировать в яму заразителей
Мэтт Хорнер	c	Мэтт Хорнер
Наблюдатель	c	наблюдатель
Надежные ворота	c	надежные ворота
Надзиратель	c	надзиратель
Надзиратель мутирует во владыку	c	надзиратель мутирует во владыку
Наноремонт	c	наноремонт
Нанять «Блок B»	c	нанять «Блок B»
Нанять «Возмездие Джексона»	c	нанять «Возмездие Джексона»
Научное судно	c	научное судно
Научный комплекс	c	научный комплекс
Начало	c	начало
Не открывать огонь	c	не открывать огонь
Невидимый пилон	c	невидимый пилон
Невральный паразит	c	невральный паразит
Нексус	c	нексус
Нервный узел Сверхразума	c	нервный узел Сверхразума
Нетупырь	c	нетупырь
Неуязвимая ракета	c	неуязвимая ракета
Нитроускорители	c	нитроускорители
Нова	c	Нова
Нож Тоша	c	нож Тоша
Обелиск	c	обелиск
Обломки «Одина»	c	обломки «одина»
Облучение	c	облучение
Образец кости осквернителя	c	образец кости осквернителя
Образец ткани пожирателя	c	образец ткани пожирателя
Обратное преобразование	c	обратное преобразование
Обучение	c	обучение
Обучить головореза	c	обучить головореза
Обучить мародера	c	обучить мародера
Обучить медика	c	обучить медика
Обучить морпеха	c	обучить морпеха
Обучить огнеметчика	c	обучить огнеметчика
Обучить призрака	c	обучить призрака
Обучить фантома	c	обучить фантома
Обшивка «Джаггернаут»	c	обшивка «Джаггернаут»
Обычный режим	c	обычный режим
Овца	c	овца
Огнеметчик	c	огнеметчик
Огненная Бетти	c	Огненная Бетти
Окно	c	окно
Октаэдр	c	октаэдр
Омегалиск	c	омегалиск
Омут рождения	c	омут рождения
Опустить	c	опустить
Опустить библиотеку	c	опустить библиотеку
Опухоль	c	опухоль
Орудие «Ямато»	c	орудие «Ямато»
Оружейная	c	оружейная
Оружие	c	оружие
Оружие зараженных терранов	c	оружие зараженных терранов
Оружие тараканов	c	оружие тараканов
Оружие хозяина стаи	c	оружие хозяина стаи
Осада	c	осада
Осветительный луч	c	осветительный луч
Осколки минеральных кристаллов	c	осколки минеральных кристаллов
Оставить предмет	c	оставить предмет
Отдача	c	отдача
Откл. легкий мост	c	откл. легкий мост
Отключить	c	отключить
Отключить легкий мост	c	отключить легкий мост
Открыть ворота	c	открыть ворота
Открыть тюрьму тал-дарим	c	открыть тюрьму тал-дарим
Отмена сбора терразина	c	отмена сбора терразина
Отменить	c	отменить
Отпустить	c	отпустить
Отпустить слугу	c	отпустить слугу
Отряд спартанцев	c	отряд спартанцев
Отставить	c	отставить
Отставить особую атаку	c	отставить особую атаку
Отстыковать	c	отстыковать
Охладительная башня	c	охладительная башня
Охотники Пустошей	c	охотники Пустошей
Охотник-убийца	c	охотник-убийца
Охранный щит	c	охранный щит
Эволюционная камера	c	эволюционная камера
Паразитические споры	c	паразитические споры
Патроны «Жало»	c	патроны «Жало»
Патроны U-238	c	патроны U-238
Патрулировать	c	патрулировать
Паучьи мины	c	паучьи мины
Паучья мина	c	паучья мина
Пенный наполнитель	c	пенный наполнитель
Перезарядка паучьих мин	c	перезарядка паучьих мин
Переключение энергии	c	переключение энергии
Переливание	c	переливание
Перенаправить атаку	c	перенаправить атаку
Перенаправление остановки	c	перенаправление остановки
Перенаправление стимуляторов	c	перенаправление стимуляторов
Переоборудование в планетарную крепость	c	переоборудование в планетарную крепость
Переоборудовать в станцию наблюдения	c	переоборудовать в станцию наблюдения
Перерабатывающий завод	c	перерабатывающий завод
Переродиться в архонта	c	переродиться в архонта
Перерождение в архонта	c	перерождение в архонта
Пещера ультралисков	c	пещера ультралисков
Пигалиск	c	пигалиск
Пилон	c	пилон
Пирамида	c	пирамида
Плазменные торпеды	c	плазменные торпеды
Планетарная крепость	c	планетарная крепость
Повернуть налево	c	повернуть налево
Повернуть направо	c	повернуть направо
Повернуться	c	повернуться
Поглотить ДНК	c	поглотить ДНК
Поглощение	c	поглощение
Подготовить ядерную ракету	c	подготовить ядерную ракету
Подиум	c	подиум
Поднять	c	поднять
Поднять библиотеку	c	поднять библиотеку
Подобрать	c	подобрать
Подобрать предмет	c	подобрать предмет
Подчинение	c	подчинение
Подъем уборной тауренов	c	подъем уборной тауренов
Поедатель	c	поедатель
Поезд Доминиона	c	поезд Доминиона
Пожиратель	c	пожиратель
Поиск	c	поиск
Полет	c	полет
Ползучий плеточник	c	ползучий плеточник
Ползучий споровик	c	ползучий споровик
Полностью восстановить запас здоровья	c	полностью восстановить запас здоровья
Полностью восстановить энергию	c	полностью восстановить энергию
Поочередное создание паучьих мин	c	поочередное создание паучьих мин
Породить аберрацию	c	породить аберрацию
Породить губителя	c	породить губителя
Породить зараженного морпеха	c	породить зараженного морпеха
Породить зараженного террана	c	породить зараженного террана
Породить королеву	c	породить королеву
Породить личинок	c	породить личинок
Породить муталиска	c	породить муталиска
Породить хозяина стаи	c	породить хозяина стаи
Порождение королевы	c	порождение королевы
Порождение мимикрида	c	порождение мимикрида
Порча	c	порча
Посадка	c	посадка
Постоянная маскировка	c	постоянная маскировка
Построить	c	построить
Построить «Аспид»	c	построить «Аспид»
Построить «Банши»	c	построить «Банши»
Построить «Викинг»	c	построить «Викинг»
Построить «Ворон»	c	построить «Ворон»
Построить «Геллион»	c	построить «Геллион»
Построить «Геркулес»	c	построить «Геркулес»
Построить «Голиафа»	c	построить «Голиафа»
Построить «Мираж»	c	построить «Мираж»
Построить «Одина»	c	построить «Одина»
Построить «Стервятник»	c	построить «Стервятник»
Построить «Тор»	c	построить «Тор»
Построить «Хищник»	c	построить «Хищник»
Построить автоматический компрессор	c	построить автоматический компрессор
Построить автотурель	c	построить автотурель
Построить академию призраков	c	построить академию призраков
Построить арсенал	c	построить арсенал
Построить бункер	c	построить бункер
Построить дополнительное здание	c	построить дополнительное здание
Построить завод	c	построить завод
Построить здание	c	построить здание
Построить инженерный комплекс	c	построить инженерный комплекс
Построить казармы	c	построить казармы
Построить командный центр	c	построить командный центр
Построить командный центр с космической антенной	c	построить командный центр с космической антенной
Построить космопорт	c	построить космопорт
Построить крейсер	c	построить крейсер
Построить КСМ	c	построить КСМ
Построить лабораторию	c	построить лабораторию
Построить лабораторный реактор	c	построить лабораторный реактор
Построить медэвак	c	построить медэвак
Построить модуль точечной защиты	c	построить модуль точечной защиты
Построить научное судно	c	построить научное судно
Построить нейтронную пушку	c	построить нейтронную пушку
Построить осадный танк	c	построить осадный танк
Построить перерабатывающий завод	c	построить перерабатывающий завод
Построить притон наемников	c	построить притон наемников
Построить пси-разрушитель	c	построить пси-разрушитель
Построить радарную вышку	c	построить радарную вышку
Построить ракетную турель	c	построить ракетную турель
Построить реактор	c	построить реактор
Построить турель «Погибель»	c	построить турель «погибель»
Построить укрепленный бункер	c	построить укрепленный бункер
Построить хранилище	c	построить хранилище
Построить центр секретных операций	c	построить центр секретных операций
Построить центр синтеза	c	построить центр синтеза
Построить эмулятор разума улья	c	построить эмулятор разума улья
Постройка канала Нидуса	c	постройка канала Нидуса
Поток разума	c	поток разума
Появление яйца	c	появление яйца
Предметы	c	предметы
Прекратить атаку	c	прекратить атаку
Прекратить особую атаку	c	прекратить особую атаку
Преобразовать во врата	c	преобразовать во врата
Преобразовать во врата искривления	c	преобразовать во врата искривления
Преодоление уступов	c	преодоление уступов
Препятствие для подъемника	c	препятствие для подъемника
Прервать вырабатывание слизи	c	прервать вырабатывание слизи
Прервать постройку	c	прервать постройку
Призвать червя Нидуса	c	призвать червя Нидуса
Приземлиться	c	приземлиться
Призма искривления	c	призма искривления
Призматический луч	c	призматический луч
Призрак	c	призрак
Призрачные гидралиски	c	призрачные гидралиски
Призрачные зерглинги	c	призрачные зерглинги
Призрачный муталиск	c	призрачный муталиск
Приостановить	c	приостановить
Припарковать	c	припарковать
Пристройки	c	пристройки
Пристройки терранов	c	пристройки терранов
Притон наемников	c	притон наемников
Провокация	c	провокация
Прожектора громкоговорителя	c	прожектора громкоговорителя
Промышленная взрывчатка	c	промышленная взрывчатка
Пространственный переход	c	пространственный переход
Простые мутации	c	простые мутации
Протокол бессмертия	c	протокол бессмертия
Профилированная обшивка	c	профилированная обшивка
Процесс строительства канала Нидуса	c	процесс строительства канала Нидуса
Прочные щиты	c	прочные щиты
Пси-импульс	c	пси-импульс
Псионная ударная волна	c	псионная ударная волна
Псионные элементы протоссов	c	псионные элементы протоссов
Псионный радар	c	псионный радар
Псионный хлыст	c	псионный хлыст
Псионный шторм	c	псионный шторм
Псионный щит	c	псионный щит
Пси-разлом	c	пси-разлом
Пси-удар	c	пси-удар
Пси-шторм	c	пси-шторм
Пулемет морпеха	c	пулемет морпеха
Пустить корни	c	пустить корни
Пустой талдаримский алтарь	c	пустой талдаримский алтарь
Пушка	c	пушка
Пушка «Ямато»	c	пушка «Ямато»
Рабочий	c	рабочий
Радар	c	радар
Радарная вышка	c	радарная вышка
Радостный мячик	c	радостный мячик
Радость	c	радость
Разведчик	c	разведчик
Развернуться	c	развернуться
Развитие	c	развитие
Развить адреналиновые железы	c	развить адреналиновые железы
Развить анаболический синтез	c	развить анаболический синтез
Развить атаку ближнего боя, уровень 1	c	развить атаку ближнего боя, уровень 1
Развить атаку ближнего боя, уровень 2	c	развить атаку ближнего боя, уровень 2
Развить атаку ближнего боя, уровень 3	c	развить атаку ближнего боя, уровень 3
Развить атаку воздушных войск, уровень 1	c	развить атаку воздушных войск, уровень 1
Развить атаку воздушных войск, уровень 2	c	развить атаку воздушных войск, уровень 2
Развить атаку воздушных войск, уровень 3	c	развить атаку воздушных войск, уровень 3
Развить атаку дальнего боя, уровень 1	c	развить атаку дальнего боя, уровень 1
Развить атаку дальнего боя, уровень 2	c	развить атаку дальнего боя, уровень 2
Развить атаку дальнего боя, уровень 3	c	развить атаку дальнего боя, уровень 3
Развить брюшные мешки	c	развить брюшные мешки
Развить глиоцитарное восстановление	c	развить глиоцитарное восстановление
Развить когти-землерои	c	развить когти-землерои
Развить круговые зацепы	c	развить круговые зацепы
Развить мощную перистальтику	c	развить мощную перистальтику
Развить облегченный панцирь	c	развить облегченный панцирь
Развить органический панцирь	c	развить органический панцирь
Развить панцири воздушных войск, уровень 1	c	развить панцири воздушных войск, уровень 1
Развить панцири воздушных войск, уровень 2	c	развить панцири воздушных войск, уровень 2
Развить панцири воздушных войск, уровень 3	c	развить панцири воздушных войск, уровень 3
Развить панцири наземных войск, уровень 1	c	развить панцири наземных войск, уровень 1
Развить панцири наземных войск, уровень 2	c	развить панцири наземных войск, уровень 2
Развить панцири наземных войск, уровень 3	c	развить панцири наземных войск, уровень 3
Развить парную инкубацию	c	развить парную инкубацию
Развить патогенные железы	c	развить патогенные железы
Развить способность закапываться	c	развить способность закапываться
Развить трубчатый позвоночник	c	развить трубчатый позвоночник
Развить ускоренный метаболизм	c	развить ускоренный метаболизм
Развить хитиновый панцирь	c	развить хитиновый панцирь
Разместить модуль точечной обороны	c	разместить модуль точечной обороны
Разместить турель	c	разместить турель
Размещение зародышей зараженных терранов	c	размещение зародышей зараженных терранов
Разработать боевой щит	c	разработать боевой щит
Разработать врата искривления	c	разработать врата искривления
Разработать гравипривод	c	разработать гравипривод
Разработать гравитационные ускорители	c	разработать гравитационные ускорители
Разработать гравитонную катапульту	c	разработать гравитонную катапульту
Разработать гравиускорители	c	разработать гравиускорители
Разработать дальнобойный термальный луч	c	разработать дальнобойный термальный луч
Разработать запал «Адское пламя»	c	разработать запал «Адское пламя»
Разработать кайдаринский амулет	c	разработать кайдаринский амулет
Разработать каркас из неостали	c	разработать каркас из неостали
Разработать маскировку для «Миража»	c	разработать маскировку для «Миража»
Разработать маскировочное поле	c	разработать маскировочное поле
Разработать нитроускорители	c	разработать нитроускорители
Разработать осадные технологии	c	разработать осадные технологии
Разработать паучьи мины	c	разработать паучьи мины
Разработать поточные турбины	c	разработать поточные турбины
Разработать прочные материалы	c	разработать прочные материалы
Разработать ракеты «Гончая»	c	разработать ракеты «Гончая»
Разработать реактор «Вран»	c	разработать реактор «Вран»
Разработать реактор «Вулкан»	c	разработать реактор «Вулкан»
Разработать реактор «Кадуцей»	c	разработать реактор «Кадуцей»
Разработать реактор «Мебиус»	c	разработать реактор «Мебиус»
Разработать сингулярный заряд	c	разработать сингулярный заряд
Разработать систему высокоточного автослежения	c	разработать систему высокоточного автослежения
Разработать системы вооружения	c	разработать системы вооружения
Разработать способность «Иллюзия»	c	разработать способность «Иллюзия»
Разработать способность «Личная маскировка»	c	разработать способность «Личная маскировка»
Разработать способность «Псионный шторм»	c	разработать способность «Псионный шторм»
Разработать способность «Рывок»	c	разработать способность «рывок»
Разработать способность «Скачок»	c	разработать способность «Скачок»
Разработать стимуляторы	c	разработать стимуляторы
Разработать ускорители «Йотун»	c	разработать ускорители «йотун»
Разработать ускорители «Харон»	c	разработать ускорители «Харон»
Разработать фугасные гранаты	c	разработать фугасные гранаты
Разработка	c	разработка
Разрушаемые камни	c	разрушаемые камни
Разрушаемые обломки	c	разрушаемые обломки
Разрушаемый каменный навес	c	разрушаемый каменный навес
Разрушаемый камень	c	разрушаемый камень
Разрушение	c	разрушение
Ракета «Гончая»	c	ракета «Гончая»
Ракета «Разрушитель»	c	ракета «разрушитель»
Ракетная батарея «Шквал»	c	ракетная батарея «Шквал»
Ракетная турель	c	ракетная турель
Ракетная шахта	c	ракетная шахта
Ракетное заграждение	c	ракетное заграждение
Ракетные модули	c	ракетные модули
Ракетные модули «Ураган»	c	ракетные модули «Ураган»
Ракетные установки «Адский шторм»	c	ракетные установки «Адский шторм»
Ракеты «Адский шторм»	c	ракеты «Адский шторм»
Ракеты «Волнорез»	c	ракеты «Волнорез»
Ракеты «Разрушитель»	c	ракеты «разрушитель»
Раскалыватель планет	c	раскалыватель планет
Рассадник тараканов	c	рассадник тараканов
Растительность	c	растительность
Реактор	c	реактор
Режим истребителя	c	режим истребителя
Режим осады	c	режим осады
Режим транспортировки	c	режим транспортировки
Рейнор	c	Рейнор
Реклама Буббы	c	реклама Буббы
Рекламный щит	c	рекламный щит
Реликвия протоссов	c	реликвия протоссов
Ремонт	c	ремонт
Ремонтировать	c	ремонтировать
Робототехнический узел	c	робототехнический узел
Рори Свонн	c	Рори Свонн
Рывок	c	рывок
Самец карака	c	самец карака
Самец медведня	c	самец медведня
Самка карака	c	самка карака
Самка медведня	c	самка медведня
Сбор	c	сбор
Сброс припасов	c	сброс припасов
Сверхразум	c	Сверхразум
Светопогащающее покрытие	c	светопогащающее покрытие
Светофор	c	светофор
Свинцовый град	c	свинцовый град
Свободный огонь	c	свободный огонь
Свонн	c	Свонн
Святилище зел-нага	c	святилище зел-нага
Сейсмический заряд	c	сейсмический заряд
Секретные документы	c	секретные документы
Семена Роя	c	семена Роя
Сеть Нидуса	c	сеть Нидуса
Силовое поле	c	силовое поле
Симбионт	c	симбионт
Системы наведения класса «Арес»	c	системы наведения класса «Арес»
Скарабей	c	скарабей
Скачок	c	скачок
Склад джория	c	склад джория
Сковывающая слизь	c	сковывающая слизь
Сколопендра	c	сколопендра
Скругленный куб	c	скругленный куб
Скрытень	c	скрытень
Скрыть	c	скрыть
Слава Доминиона	c	Слава Доминиона
Слепень	c	слепень
Сложные мутации	c	сложные мутации
Сменить оружие	c	сменить оружие
Смертельное видение	c	смертельное видение
Снайпер	c	снайпер
Снайперский выстрел	c	снайперский выстрел
Снаряды «Вихрь»	c	снаряды «Вихрь»
Собака	c	собака
Создание паучьих мин	c	создание паучьих мин
Создать 2 иллюзии высшего тамплиера	c	создать 2 иллюзии высшего тамплиера
Создать 2 иллюзии зилота	c	создать 2 иллюзии зилота
Создать 2 иллюзии сталкера	c	создать 2 иллюзии сталкера
Создать 4 иллюзии зонда	c	создать 4 иллюзии зонда
Создать иллюзию архонта	c	создать иллюзию архонта
Создать иллюзию бессмертного	c	создать иллюзию бессмертного
Создать иллюзию излучателя Пустоты	c	создать иллюзию излучателя Пустоты
Создать иллюзию колосса	c	создать иллюзию колосса
Создать иллюзию призмы искривления	c	создать иллюзию призмы искривления
Создать иллюзию феникса	c	создать иллюзию феникса
Создать опухоль	c	создать опухоль
Создать перехватчик	c	создать перехватчик
Сосуд для образцов ткани пожирателя	c	сосуд для образцов ткани пожирателя
Сотрясающий прыжок	c	сотрясающий прыжок
Спаренные огнеметы	c	спаренные огнеметы
Список способностей	c	список способностей
Споровое орудие	c	споровое орудие
Спутниковое сканирование	c	спутниковое сканирование
Стабилизаторы	c	стабилизаторы
Стадный инстинкт	c	стадный инстинкт
Сталкер	c	сталкер
Станция наблюдения	c	станция наблюдения
Статический разряд	c	статический разряд
Статуя волка	c	статуя волка
Статуя Менгска	c	статуя Менгска
Стена огня	c	стена огня
Стервятник	c	стервятник
Стетманн	c	Стетманн
Стимуляторы	c	стимуляторы
стоп	c	стоп
Страж	c	страж
Стрельба на ходу	c	стрельба на ходу
Стригущий рой	c	стригущий рой
Строительство	c	строительство
Стыковка	c	стыковка
Сумеречный совет	c	сумеречный совет
Сумка на 10 ячеек	c	сумка на 10 ячеек
Сумка на 12 ячеек	c	сумка на 12 ячеек
Сумка на 14 ячеек	c	сумка на 14 ячеек
Сумка на 16 ячеек	c	сумка на 16 ячеек
Сумка на 18 ячеек	c	сумка на 18 ячеек
Сумка на 20 ячеек	c	сумка на 20 ячеек
Сумка на 22 ячейки	c	сумка на 22 ячейки
Сумка на 24 ячейки	c	сумка на 24 ячейки
Сумка на 4 ячейки	c	сумка на 4 ячейки
Сумка на 6 ячеек	c	сумка на 6 ячеек
Сумка на 8 ячеек	c	сумка на 8 ячеек
Сумрачная стая	c	Сумрачная стая
Супер врата искривления	c	супер врата искривления
Суперкран	c	суперкран
Сфера	c	сфера
Сферы Пустоты	c	сферы Пустоты
Сфокусированный выстрел	c	сфокусированный выстрел
Тайкус	c	Тайкус
Тайкус Финдли	c	Тайкус Финдли
Тактический ядерный удар	c	тактический ядерный удар
Талдаримская темница	c	талдаримская темница
Танец	c	танец
Таракан	c	таракан
Тассадар	c	Тассадар
Таурен-космодесантник	c	таурен-космодесантник
Темное святилище	c	темное святилище
Темный тамплиер	c	темный тамплиер
Темпоральный разлом	c	темпоральный разлом
Теневые клоны	c	теневые клоны
Тень фантома	c	тень фантома
Термитная смесь	c	термитная смесь
Тетраэдр	c	тетраэдр
Титановая обшивка	c	титановая обшивка
Ткань пожирателя	c	ткань пожирателя
Толстый тор	c	толстый тор
Тонкий тор	c	тонкий тор
Тор	c	Тор
Точка атаки	c	точка атаки
Точка защиты	c	точка защиты
Точка прессинга	c	точка прессинга
Точка разведки	c	точка разведки
Точка расстройки	c	точка расстройки
Точка сбора	c	точка сбора
Тош	c	Тош
Транспорт	c	транспорт
Транспорт «Геркулес»	c	транспорт «Геркулес»
Транспортировка	c	транспортировка
Транспортировка уборной тауренов	c	транспортировка уборной тауренов
Трансформировать в лабораторный реактор	c	трансформировать в лабораторный реактор
Трансформировать перерабатывающий завод в автоматический перерабатывающий завод	c	трансформировать перерабатывающий завод в автоматический перерабатывающий завод
Тревога	c	тревога
Трилитиевые батареи	c	трилитиевые батареи
Триллик	c	триллик
Турель «Погибель»	c	турель «Погибель»
Турель «Шрайк»	c	турель «Шрайк»
Тюремный блок Б	c	тюремный блок Б
Тюрьма хранителей	c	тюрьма хранителей
Тяжелобронированный	c	тяжелобронированный
Уборная тауренов	c	уборная тауренов
Ударная волна	c	ударная волна
Ударная волна королевы	c	ударная волна королевы
Удерживать позицию	c	удерживать позицию
Узы Пустоты	c	Узы Пустоты
Указатель	c	указатель
Укрепить броню воздушных войск, уровень 1	c	укрепить броню воздушных войск, уровень 1
Укрепить броню воздушных войск, уровень 2	c	укрепить броню воздушных войск, уровень 2
Укрепить броню воздушных войск, уровень 3	c	укрепить броню воздушных войск, уровень 3
Укрепить броню наземных войск, уровень 1	c	укрепить броню наземных войск, уровень 1
Укрепить броню наземных войск, уровень 2	c	укрепить броню наземных войск, уровень 2
Укрепить броню наземных войск, уровень 3	c	укрепить броню наземных войск, уровень 3
Укрепить броню пехоты, уровень 1	c	укрепить броню пехоты, уровень 1
Укрепить броню пехоты, уровень 2	c	укрепить броню пехоты, уровень 2
Укрепить броню пехоты, уровень 3	c	укрепить броню пехоты, уровень 3
Укрепить обшивку воздушной техники, уровень 1	c	укрепить обшивку воздушной техники, уровень 1
Укрепить обшивку воздушной техники, уровень 2	c	укрепить обшивку воздушной техники, уровень 2
Укрепить обшивку воздушной техники, уровень 3	c	укрепить обшивку воздушной техники, уровень 3
Укрепить обшивку наземной техники, уровень 1	c	укрепить обшивку наземной техники, уровень 1
Укрепить обшивку наземной техники, уровень 2	c	укрепить обшивку наземной техники, уровень 2
Укрепить обшивку наземной техники, уровень 3	c	укрепить обшивку наземной техники, уровень 3
Укрепить обшивку построек	c	укрепить обшивку построек
Укрепить щиты, уровень 1	c	укрепить щиты, уровень 1
Укрепить щиты, уровень 2	c	укрепить щиты, уровень 2
Укрепить щиты, уровень 3	c	укрепить щиты, уровень 3
Укрепленный бункер	c	укрепленный бункер
Улаанский задымленный мост	c	улаанский задымленный мост
Улей	c	улей
Улучшенный рободоктор	c	улучшенный рободоктор
Улучшить вооружение воздушной техники, уровень 1	c	улучшить вооружение воздушной техники, уровень 1
Улучшить вооружение воздушной техники, уровень 2	c	улучшить вооружение воздушной техники, уровень 2
Улучшить вооружение воздушной техники, уровень 3	c	улучшить вооружение воздушной техники, уровень 3
Улучшить вооружение воздушных войск, уровень 1	c	улучшить вооружение воздушных войск, уровень 1
Улучшить вооружение воздушных войск, уровень 2	c	улучшить вооружение воздушных войск, уровень 2
Улучшить вооружение воздушных войск, уровень 3	c	улучшить вооружение воздушных войск, уровень 3
Улучшить вооружение наземной техники, уровень 1	c	улучшить вооружение наземной техники, уровень 1
Улучшить вооружение наземной техники, уровень 2	c	улучшить вооружение наземной техники, уровень 2
Улучшить вооружение наземной техники, уровень 3	c	улучшить вооружение наземной техники, уровень 3
Улучшить вооружение наземных войск, уровень 1	c	улучшить вооружение наземных войск, уровень 1
Улучшить вооружение наземных войск, уровень 2	c	улучшить вооружение наземных войск, уровень 2
Улучшить вооружение наземных войск, уровень 3	c	улучшить вооружение наземных войск, уровень 3
Улучшить вооружение пехоты, уровень 1	c	улучшить вооружение пехоты, уровень 1
Улучшить вооружение пехоты, уровень 2	c	улучшить вооружение пехоты, уровень 2
Улучшить вооружение пехоты, уровень 3	c	улучшить вооружение пехоты, уровень 3
Ультразвуковой импульс	c	ультразвуковой импульс
Ультралиск	c	ультралиск
Управление воротами	c	управление воротами
Урун	c	Урун
Ускоренное строительство	c	ускоренное строительство
Ускоренный ремонт	c	ускоренный ремонт
Установить «Огненную Бетти»	c	установить «Огненную Бетти»
Установка автоматической пушки	c	установка автоматической пушки
Установка паучьей мины	c	установка паучьей мины
Ученый	c	ученый
Фазовый режим	c	фазовый режим
Фазовый сдвиг	c	фазовый сдвиг
Фантом	c	фантом
Феникс	c	Феникс
Флаг	c	флаг
Фонарь	c	фонарь
Форпост наемников	c	форпост наемников
Фотонная пушка	c	фотонная пушка
Фугасные гранаты	c	фугасные гранаты
Хилл	c	хилл
Хищник	c	хищник
Хозяин стаи	c	хозяин стаи
Храм зел-нага	c	храм зел-нага
Хранилище	c	хранилище
Хранилище данных	c	хранилище данных
Хранитель	c	хранитель
Хризалида	c	хризалида
Хризалида Керриган	c	хризалида Керриган
Цель	c	цель
Центр секретных операций	c	центр секретных операций
Центр синтеза	c	центр синтеза
Центральная консоль	c	центральная консоль
Цепная молния	c	цепная молния
Цилиндр	c	цилиндр
Часовой	c	часовой
Червь Нидуса	c	червь Нидуса
Черный окаймляющий бордюр	c	черный окаймляющий бордюр
Черный ящик	c	черный ящик
Шахтер	c	шахтер
Шипастая рептилия	c	шипастая рептилия
Шпиль	c	шпиль
Шпиль величия	c	шпиль величия
Шпиль заражения	c	шпиль заражения
Штаб снабжения	c	штаб снабжения
Штабной биокупол	c	штабной биокупол
Штурмовой режим	c	штурмовой режим
Экспериментальная плазменная пушка	c	экспериментальная плазменная пушка
Экстрактор	c	экстрактор
Электрическое поле	c	электрическое поле
Электромагнитная волна	c	электромагнитная волна
ЭМИ	c	ЭМИ
Эмулятор разума улья	c	эмулятор разума улья
Энергетическая перезарядка	c	энергетическая перезарядка
Энергетический взрыв	c	энергетический взрыв
Энергетическое ядро «Томагавк»	c	энергетическое ядро «Томагавк»
Энергия +100	c	энергия +100
Энергия +25	c	энергия +25
Энергия +50	c	энергия +50
Энергия включена	c	энергия включена
Энергия отключена	c	энергия отключена
Эрл	c	Эрл
Ядерная ракета фантома	c	ядерная ракета фантома
Ядерный реактор	c	ядерный реактор
Ядерный удар	c	ядерный удар
Яма заразителей	c	яма заразителей
Ямато	c	Ямато
Яства тысячи пиршеств	c	яства тысячи пиршеств
Ящики с паучьими минами	c	ящики с паучьими минами
Ящики с припасами призраков	c	ящики с припасами призраков
Ящики с припасами фантомов	c	ящики с припасами фантомов
Реклама пси-батальона	c	реклама пси-батальона
«Боевые кабаны»	c	«Боевые кабаны»
Наемник из «Боевых кабанов»	c	наемник из «Боевых кабанов»
«Адские Псы»	c	«Адские Псы»
Наемник из «Адских Псов»	c	наемник из «Адских Псов»
«Топ-секьюрити»	a	наемника из «Топ-секьюрити»
«Топ-секьюрити»	c	«Топ-секьюрити»
Наемник из «Топ-секьюрити»	c	наемник из «Топ-секьюрити»
«Отряд спартанцев»	c	«Отряд спартанцев»
Наемник из «Отряда спартанцев»	c	наемник из «Отряда спартанцев»
«Мастера осады»	c	«Мастера осады»
Наемник из «Мастеров осады»	c	наемник из «Мастеров осады»
«Ангелы Аида»	c	«Ангелы Аида»
Наемник из «Ангелов Аида»	c	наемник из «Ангелов Аида»
«Сумрачная стая»	c	«Сумрачная стая»
Наемник из «Сумрачной стаи»	a	наемника из«Сумрачной стаи»
Наемник из «Сумрачной стаи»	c	наемник из «Сумрачной стаи»
«Банши» «Гипериона»	c	«Банши» «Гипериона»
«Банши» «Гипериона» 2	c	«Банши» «Гипериона» 2
«Банши» «Гипериона» 3	c	«Банши» «Гипериона» 3
«Гиперион» - орудие «Ямато»	c	«Гиперион» - орудие «Ямато»
«Хищник» - маскировка	c	«Хищник» - маскировка
«Ямато» [уровень 1]	c	«Ямато» [уровень 1]
«Ямато» [уровень 2]	c	«Ямато» [уровень 2]
«Ямато» [уровень 3]	c	«Ямато» [уровень 3]
«Ямато» [уровень 4]	c	«Ямато» [уровень 4]
HotS - хранитель - линейный всплеск 	c	HotS - хранитель - линейный всплеск
X88T - бронебойный	c	X88T - бронебойный
X88T - замыкание	c	X88T - замыкание
X88T - напалм	c	X88T - напалм
Автоматический экстрактор	c	автоматический экстрактор
Агрессивность	c	агрессивность
Адаптивный панцирь	c	адаптивный панцирь
Адреналиновые железы	c	адреналиновые железы
Активация пульсарного луча	c	активация пульсарного луча
Активировать мину	c	активировать мину
Ангел Скиби	c	ангел Скиби
Апокалипсис	c	апокалипсис
Артиллерийский обстрел	c	артиллерийский обстрел
Ассимиляция тканей	c	ассимиляция тканей
Атака в неистовстве	c	атака в неистовстве
Атака истребителей [уровень 1]	c	атака истребителей [уровень 1]
Атака истребителей [уровень 2]	c	атака истребителей [уровень 2]
Атака истребителей [уровень 3]	c	атака истребителей [уровень 3]
Атака истребителей [уровень 4]	c	атака истребителей [уровень 4]
Атака плеточника	c	атака плеточника
Атаковать строения	c	атаковать строения
Аура великолепия	c	аура великолепия
Аура регенерации	c	аура регенерации
Бегство существа	c	бегство существа
Безбашенный	c	безбашенный
Бесчисленный рой	c	бесчисленный рой
Бешенство саранчидов	c	бешенство саранчидов
Биокислоты	c	биокислоты
Боевой прыжок	c	боевой прыжок
Бомбардировка	c	бомбардировка
Бомбардировщик	c	бомбардировщик
Бронебойные орудия	c	бронебойные орудия
Бронебойные ракеты	c	бронебойные ракеты
Бронебойные шипы	c	бронебойные шипы
БТР	c	БТР
БТР - выгрузить всех	c	БТР - выгрузить всех
БТР - загрузить	c	БТР - загрузить
Быстрая инкубация	c	быстрая инкубация
Быстрая мутация	c	быстрая мутация
Быстрая регенерация тараканов	c	быстрая регенерация тараканов
Быстрое восстановление	c	быстрое восстановление
Быстрое переливание	c	быстрое переливание
Быстрое рождение личинок	c	быстрое рождение личинок
Быстрое созревание	c	быстрое созревание
Быстрые метаморфозы	c	быстрые метаморфозы
Быстрые саранчиды	c	быстрые саранчиды
Быстрый генезис	c	быстрый генезис
В бой!	c	в бой!
Валькирия	c	валькирия
Вампирическая аура	c	вампирическая аура
Взрывные шипы	c	взрывные шипы
Возвращение «Банши» на «Гиперион»	c	возвращение «банши» на «гиперион»
Воздаяние	c	воздаяние
Возрождение	c	возрождение
Возрождение войск Керриган - боец	c	возрождение войск Керриган - боец
Возрождение войск Керриган - невоздушная единица	c	возрождение войск Керриган - невоздушная единица
Возрождение войск Керриган - порча	c	возрождение войск Керриган - порча
Возрождение войск Керриган - спецназ	c	возрождение войск Керриган - спецназ
Возрождение временно недоступно	c	возрождение временно недоступно
Возрождение Королевы Клинков	c	возрождение Королевы Клинков
Возрождение Королевы Клинков в инкубаторе	c	возрождение Королевы Клинков в инкубаторе
Возрождение омегалиска	c	возрождение омегалиска
Войска наемников	c	войска наемников
Волокнистые внутренности	c	волокнистые внутренности
Воскрешение с размещением	c	воскрешение с размещением
Воспламеняющие споры	c	воспламеняющие споры
Воссоздание	c	воссоздание
Восстановить щиты	c	восстановить щиты
Восстановление атаки ультралиска	c	восстановление атаки ультралиска
Восстановление зерглингов	c	восстановление зерглингов
Восстановление клеток	c	восстановление клеток
Восстановление ракетного танка	c	восстановление ракетного танка
Вредоносная слизь	c	вредоносная слизь
Вредоносное облако	c	вредоносное облако
Вредоносные испарения	c	вредоносные испарения
Вспомогательные органы	c	вспомогательные органы
Вспомогательный панцирь	c	вспомогательный панцирь
Выброс адреналина	c	выброс адреналина
Выдвижение моста	c	выдвижение моста
Вызвать великого червя нидуса	c	вызвать великого червя нидуса
Вызвать метатель слизи	c	вызвать метатель слизи
Вызвать оракула	c	вызвать оракула
Вызвать разрушителя нидуса	c	вызвать разрушителя нидуса
Вызвать ураган	c	вызвать ураган
Вызвать ядро материнского корабля	c	вызвать ядро материнского корабля
Вызов корабля - возврат	c	вызов корабля - возврат
Выйти из режима воздаяния	c	выйти из режима воздаяния
Вырасти	c	вырасти
Вязкие выделения	c	вязкие выделения
Вязкий выплеск	c	вязкий выплеск
Газовое облако	c	газовое облако
Гидралиск-пронзатель	c	гидралиск-пронзатель
Гидралиск-скрытень	c	гидралиск-скрытень
Глазной стебелек	c	глазной стебелек
Глубинный тоннель	c	глубинный тоннель
Гнев зел-нага	c	гнев зел-нага
Гнев Керриган	c	гнев Керриган
Гнездо симбионтов	c	гнездо симбионтов
Гнилая слизь - улучшение	c	гнилая слизь - улучшение
Готовность к бою	c	готовность к бою
Гравитационный колодец	c	гравитационный колодец
Граната	c	граната
Грифон	c	грифон
Губительная копьезмейка	c	губительная копьезмейка
Деактивация пульсарного луча	c	деактивация пульсарного луча
Деактивировать мину	c	деактивировать мину
Десантные капсулы	c	десантные капсулы
Дехака	c	дехака
Дешевые инкубаторы	c	дешевые инкубаторы
Дикая агрессия	c	дикая агрессия
Дикая мутация	c	дикая мутация
Дикий рев	c	дикий рев
Длинные ноги	c	длинные ноги
Дополнительная мембрана	c	дополнительная мембрана
Дополнительный пищевод	c	дополнительный пищевод
Дроблинг	c	дроблинг
Дробящие шипы	c	дробящие шипы
Едкая жижа	c	едкая жижа
Едкая кислота	c	едкая кислота
Едкий яд	c	едкий яд
Желчные протоки	c	желчные протоки
Жертвоприношение	c	жертвоприношение
Живучесть	c	живучесть
Загрузить перевариватель	c	загрузить перевариватель
Задать точку возрождения зерглингов	c	задать точку возрождения зерглингов
Зазубренные когти	c	зазубренные когти
Зазубренный шип	c	зазубренный шип
Закапывание в каменистую почву	c	закапывание в каменистую почву
Замаскировать единицу	c	замаскировать единицу
Запретить атаку	c	запретить атаку
Запретить особые атаки	c	запретить особые атаки
Запуск	c	запуск
Запустить истребители 1	c	запустить истребители 1
Запустить ракеты	c	запустить ракеты
Заражение	c	заражение
Заражение симбионтами	c	заражение симбионтами
Заражение труплингами	c	заражение труплингами
Зараженные «Банши»	c	зараженные «банши»
Зараженные «Мастера осады»	c	зараженные «Мастера осады»
Зараженные медики	c	зараженные медики
Заразить	c	заразить
Заразить строение	c	заразить строение
Застывающая желчь - улучшение	c	застывающая желчь - улучшение
Защита	c	защита
Защита базы изначальных зергов	c	защита базы изначальных зергов
Защитная аура	c	защитная аура
Защитная матрица - поле	c	защитная матрица - поле
Защитная матрица - специализация	c	защитная матрица - специализация
Защитник	c	защитник
Защитный барьер	c	защитный барьер
Зерглингов доступно для возрождения	c	зерглингов доступно для возрождения
Зияющая пасть	c	зияющая пасть
Игнорирование брони	c	игнорирование брони
Излечение	c	излечение
Изменить боевую роль	c	изменить боевую роль
Изначальные инстинкты	c	изначальные инстинкты
Изначальный гидралиск	c	изначальный гидралиск
Изначальный зерглинг	c	изначальный зерглинг
Изначальный инкубатор	c	изначальный инкубатор
Изначальный муталиск	c	изначальный муталиск
Изначальный равазавр	c	изначальный равазавр
Изначальный таракан	c	изначальный таракан
Изначальный улей	c	изначальный улей
Изначальный ультралиск	c	изначальный ультралиск
Изначальный экстрактор	c	изначальный экстрактор
Изолирование	c	изолирование
Интенсивный режим	c	интенсивный режим
Инфекция	c	инфекция
Иодоводородная кислота	c	иодоводородная кислота
Ионные ускорители	c	ионные ускорители
Ионные ускорители [уровень 2]	c	ионные ускорители [уровень 2]
Ионные ускорители [уровень 3]	c	ионные ускорители [уровень 3]
Исключительная стойкость	c	исключительная стойкость
Использовать токсичный адреналин	c	использовать токсичный адреналин
Исступление	c	исступление
Истинная мощь	c	истинная мощь
Истинная сила	c	истинная сила
Истинная ярость	c	истинная ярость
Истинный шок	c	истинный шок
Истребитель	c	истребитель
Исцеляющий алтарь зел-нага	c	исцеляющий алтарь зел-нага
Кассетные ракеты	c	кассетные ракеты
Каустическая добавка	c	каустическая добавка
Керриган: Воздушная осада	c	керриган: воздушная осада
Кинетический митоз	c	кинетический митоз
Кинетический удар	c	кинетический удар
Клеточное дробление	c	клеточное дробление
Клон	c	клон
Когти-землерои	c	когти-землерои
Кокон воскрешения Керриган	c	кокон воскрешения керриган
Кольцо яда	c	кольцо яда
Контузящий взрыв	c	контузящий взрыв
Корабль протоссов - отстыковка	c	корабль протоссов - отстыковка
Королева - взлет	c	королева - взлет
Королева - приземление	c	королева - приземление
Королева Роя	c	королева Роя
Королева Яда	c	королева Яда
Королевские бивни	c	королевские бивни
Королевский страж	c	королевский страж
Космическая платформа - дверь - закрыта	c	космическая платформа - дверь - закрыта
Космическая платформа - дверь - открыта	c	космическая платформа - дверь - открыта
Кристалл Стукова	c	кристалл Стукова
Круговые зацепы	c	круговые зацепы
Крылья всепоглощающей ненависти	c	крылья всепоглощающей ненависти
Крылья ненависти	c	крылья ненависти
Лабораторная обойма Рейнора	c	лабораторная обойма рейнора
Летучий выброс	c	летучий выброс
Маар - конец поддержания	c	маар - конец поддержания
Маар - начало поддержания	c	маар - начало поддержания
Максимальный бросок	c	максимальный бросок
Массовое опрокидывание	c	массовое опрокидывание
Матрица «Одина»	c	матрица «Одина»
Мать Роя	c	мать Роя
Медицинский автомат	c	медицинский автомат
Медицинский автомат - подбор	c	медицинский автомат - подбор
Метание слизи	c	метание слизи
Микрофильтрация	c	микрофильтрация
Миноукладчик - атака	c	миноукладчик - атака
Миноукладчик - выкопаться	c	миноукладчик - выкопаться
Миноукладчик - закопаться	c	миноукладчик - закопаться
Миноукладчик - зарядка	c	миноукладчик - зарядка
Молодой изначальный зерг	c	молодой изначальный зерг
Мутация в пронзателя	c	мутация в пронзателя
Мутация в рабочего	c	мутация в рабочего
Мутация в саранчида	c	мутация в саранчида
Мутация гиблинга в дроблинга	c	мутация гиблинга в дроблинга
Мутация гиблинга в охотника	c	мутация гиблинга в охотника
Мутация гидралиска в пронзателя	c	мутация гидралиска в пронзателя
Мутация гидралиска в скрытня	c	мутация гидралиска в скрытня
Мутация зерглинга в раптора	c	мутация зерглинга в раптора
Мутация зерглинга в сворлинга	c	мутация зерглинга в сворлинга
Мутация роевика в падальщика	c	мутация роевика в падальщика
Мутация роевика в ползуна	c	мутация роевика в ползуна
Мутация таракана в кислота	c	мутация таракана в кислота
Мутация таракана в труповика	c	мутация таракана в труповика
Мутация ультралиска в токсилиска	c	мутация ультралиска в токсилиска
Мутация ультралиска в торраска	c	мутация ультралиска в торраска
Мутировать в аберрацию	c	мутировать в аберрацию
Мутировать в автоматический экстрактор	c	мутировать в автоматический экстрактор
Мутировать в берлогу пронзателей	c	мутировать в берлогу пронзателей
Мутировать в великую сеть нидуса	c	мутировать в великую сеть нидуса
Мутировать в закопанного изначального носителя	c	мутировать в закопанного изначального носителя
Мутировать в изначального носителя	c	мутировать в изначального носителя
Мутировать в кокон оживления Керриган	c	мутировать в кокон оживления керриган
Мутировать в муталиск - левиафан	c	мутировать в муталиск - левиафан
Мутировать в осквернителя	c	мутировать в осквернителя
Мутировать в пожирателя	c	мутировать в пожирателя
Мутировать в пронзателя	c	мутировать в пронзателя
Мутировать в роевика	c	мутировать в роевика
Мутировать в стрекозу	c	мутировать в стрекозу
Мутировать во владыку	c	мутировать во владыку
Набухшие отростки	c	набухшие отростки
Наведение	c	наведение
Нагнетательные железы	c	нагнетательные железы
Надзиратель - установить точку сбора	c	надзиратель - установить точку сбора
Нанять «Блок Б»	c	нанять «Блок Б»
Наращивание мускулов	c	наращивание мускулов
Наскок	c	наскок
Не атаковать строения	c	не атаковать строения
Неистовство	c	неистовство
Непробиваемый щит	c	непробиваемый щит
Неуязвимость	c	неуязвимость
Обновление	c	обновление
Обозначить	c	обозначить
Обработка туши иглобраза	c	обработка туши иглобраза
Обучить элитную единицу	c	обучить элитную единицу
Объединенная воля	c	объединенная воля
Обычное воскрешение	c	обычное воскрешение
Оглушительный рев	c	оглушительный рев
Огненная мех-текстура	c	огненная мех-текстура
Огненное дыхание	c	огненное дыхание
Огненный плевок	c	огненный плевок
Ограждение минералов	c	ограждение минералов
Омега-шторм	c	омега-шторм
Оплетающий язык	c	оплетающий язык
Опустить врата храма (ULDR)	c	опустить врата храма (ULDR)
Опустить врата храма (URDL)	c	опустить врата храма (URDL)
Опутывание	c	опутывание
Органический панцирь	c	органический панцирь
Ориентирование не поле боя	c	ориентирование не поле боя
Освободить ультралиска	c	освободить ультралиска
Ослабляющая слюна	c	ослабляющая слюна
Ослепляющее облако	c	ослепляющее облако
Остановить похищение жизненной силы	c	остановить похищение жизненной силы
Остановиться (особая)	c	остановиться (особая)
Отклик	c	отклик
Отмена	c	отмена
Отменить действие токсичного адреналина	c	отменить действие токсичного адреналина
Отменить закопку	c	отменить закопку
Отменить принятие боевой роли «Истинная мощь»	c	отменить принятие боевой роли «истинная мощь»
Отменить принятие боевой роли «Мать Роя»	c	отменить принятие боевой роли «мать роя»
Отменить принятие боевой роли «Порча»	c	отменить принятие боевой роли «порча»
Отменить принятие боевой роли «Разрушение»	c	отменить принятие боевой роли «разрушение»
Отозвать	c	отозвать
Отозвать истребители	c	отозвать истребители
Отпустить гибрида	c	отпустить гибрида
Охотник за ресурсами	c	охотник за ресурсами
Охотник Пустошей	c	охотник пустошей
Охранный робот	c	охранный робот
Ошеломляющий удар	c	ошеломляющий удар
Панцирь	c	панцирь
Паразитизм	c	паразитизм
Паразитическое заражение	c	паразитическое заражение
Паразитическое подчинение	c	паразитическое подчинение
Парализующие иглы	c	парализующие иглы
Перевариватель	c	перевариватель
Передача веспена	c	передача веспена
Перезарядка обелиска	c	перезарядка обелиска
Перенастройка линз	c	перенастройка линз
Перенос биомассы	c	перенос биомассы
Перенос туши	c	перенос туши
Переоборудовать в планетарную крепость	c	переоборудовать в планетарную крепость
Пиявка	c	пиявка
Плазменная пушка	c	плазменная пушка
Плазменные патроны	c	плазменные патроны
Плеточный залп	c	плеточный залп
Плотная чешуя	c	плотная чешуя
Повысить уровень «Гипериона»	c	повысить уровень «гипериона»
Повышенная угроза	c	повышенная угроза
Поглотить	c	поглотить
Поглотить носителя	c	поглотить носителя
Поглотить эссенцию	c	поглотить эссенцию
Подавление	c	подавление
Поддержание	c	поддержание
Подзарядка	c	подзарядка
Подземная волна	c	подземная волна
Подземный рывок	c	подземный рывок
Подкоп Ягдры	c	подкоп Ягдры
Поднять врата храма (ULDR)	c	поднять врата храма (ULDR)
Поднять врата храма (URDL)	c	поднять врата храма (URDL)
Подобрать большой кусок металлолома	c	подобрать большой кусок металлолома
Подобрать груз газа	c	подобрать груз газа
Подобрать груз минералов	c	подобрать груз минералов
Подобрать малый кусок металлолома	c	подобрать малый кусок металлолома
Подобрать минералы	c	подобрать минералы
Подобрать обломки	c	подобрать обломки
Подобрать средний кусок металлолома	c	подобрать средний кусок металлолома
Подтянуть	c	подтянуть
Поедание мяса	c	поедание мяса
Пожирание	c	пожирание
Пожирание трупов	c	пожирание трупов
Ползучие стражи	c	ползучие стражи
Полости с ядом	c	полости с ядом
Полые шипы	c	полые шипы
Породить гиблингов	c	породить гиблингов
Породить гидралиска	c	породить гидралиска
Породить гидралисков	c	породить гидралисков
Породить зараженных терранов	c	породить зараженных терранов
Породить зерглинга	c	породить зерглинга
Породить изначального гидралиска	c	породить изначального гидралиска
Породить изначального зерглинга	c	породить изначального зерглинга
Породить изначального ультралиска	c	породить изначального ультралиска
Породить королеву Роя	c	породить королеву Роя
Породить левиафана	c	породить левиафана
Породить личинку	c	породить личинку
Породить прислужников	c	породить прислужников
Породить равазавра	c	породить равазавра
Породить саранчида	c	породить саранчида
Породить саранчидов	c	породить саранчидов
Породить симбионтов	c	породить симбионтов
Породить таракана	c	породить таракана
Породить ультралиска	c	породить ультралиска
Порождающее сооружение изначальных зергов A	c	порождающее сооружение изначальных зергов A
Порождающее сооружение изначальных зергов B	c	порождающее сооружение изначальных зергов B
Порождающее сооружение изначальных зергов C	c	порождающее сооружение изначальных зергов C
Порождение	c	порождение
Порождение левиафана  (активная способность)	c	порождение левиафана  (активная способность)
Посмертный митоз	c	посмертный митоз
Построить «Боевого пса»	c	построить «Боевого пса»
Построить «Геллитрон»	c	построить «Геллитрон»
Построить бомбардировщики-невидимки	c	построить бомбардировщики-невидимки
Построить истребители	c	построить истребители
Построить мину «Вдова»	c	построить мину «Вдова»
Построить модуль точечной обороны	c	построить модуль точечной обороны
Построить модуль точечной обороны [уровень 1]	c	построить модуль точечной обороны [уровень 1]
Построить модуль точечной обороны [уровень 2]	c	построить модуль точечной обороны [уровень 2]
Построить модуль точечной обороны [уровень 3]	c	построить модуль точечной обороны [уровень 3]
Построить споровое орудие	c	построить споровое орудие
Поток Пустоты	c	поток Пустоты
Похищение жизненной силы	c	похищение жизненной силы
Превращение Керриган в кампании	c	превращение Керриган в кампании
Превращение Керриган в Королеву Клинков	c	превращение Керриган в королеву клинков
Превращение Керриган в летающую Керриган	c	превращение Керриган в летающую керриган
Превращение Керриган в призрака	c	превращение Керриган в призрака
Предвидение	c	предвидение
Предопределение	c	предопределение
Предсказание	c	предсказание
Прекратить ремонт	c	прекратить ремонт
Преобразование в материнский корабль	c	преобразование в материнский корабль
Прервать всепоглощающую ненависть	c	прервать всепоглощающую ненависть
Прервать выработку едкой жижи	c	прервать выработку едкой жижи
Прервать защиту	c	прервать защиту
Придаточный пищеварительный тракт	c	придаточный пищеварительный тракт
Приобрести ракеты «Циклон»	c	приобрести ракеты «Циклон»
Притягивание	c	притягивание
Пронзатель	c	пронзатель
Противодействие	c	противодействие
Противостояние	c	противостояние
Прочная стена	c	прочная стена
Прыжок	c	прыжок
Прыжок (Дехака)	c	прыжок (дехака)
Псионная тень	c	псионная тень
Псионный импульс	c	псионный импульс
Псионный сдвиг	c	псионный сдвиг
Пси-разряд	c	пси-разряд
Пси-удар - патрулирование	c	пси-удар - патрулирование
Пси-удар - передвижение	c	пси-удар - передвижение
Пси-удар - передвижение в режиме наблюдения	c	пси-удар - передвижение в режиме наблюдения
Пси-удар - поворот	c	пси-удар - поворот
Пси-удар - удерживание позиции	c	пси-удар - удерживание позиции
Пси-хватка	c	пси-хватка
Пулеметный обстрел	c	пулеметный обстрел
Пульсарный взрыв	c	пульсарный взрыв
Пульсарный луч	c	пульсарный луч
Рабочие-близнецы	c	рабочие-близнецы
Разведение моста	c	разведение моста
Развить наращивание мускулов	c	развить наращивание мускулов
Развить передвижение под землей	c	развить передвижение под землей
Развить подземный рывок	c	развить подземный рывок
Развить полые шипы	c	развить полые шипы
Развить способность «Невральный паразит»	c	развить способность «невральный паразит»
Развить челюсти-землерои	c	развить челюсти-землерои
Разгибательные мышцы	c	разгибательные мышцы
Разделение	c	разделение
Разделение роевика А	c	разделение роевика а
Разделение роевика Б	c	разделение роевика б
Разработать 250-мм орудия	c	разработать 250-мм орудия
Разработать анионные импульс-кристаллы	c	разработать анионные импульс-кристаллы
Разработать бозоновое ядро	c	разработать бозоновое ядро
Разработать дальнобойные орудия	c	разработать дальнобойные орудия
Разработать кайдариновый амулет	c	разработать кайдариновый амулет
Разработать квантовый реактор	c	разработать квантовый реактор
Разработать когти для бурения	c	разработать когти для бурения
Разработать трансформационные сервоприводы	c	разработать трансформационные сервоприводы
Разработать экспресс-лечение	c	разработать экспресс-лечение
Разрешить атаку	c	разрешить атаку
Разрыв	c	разрыв
Разум улья	c	разум улья
Ракетная вышка	c	ракетная вышка
Ракетная установка - залп	c	ракетная установка - залп
Ракетная установка - перезарядка	c	ракетная установка - перезарядка
Ракетный танк	c	ракетный танк
Ракетомет	c	ракетомет
Ракеты «Нокаут»	c	ракеты «нокаут»
Раптор - смерть	c	раптор - смерть
Раскалывающая копьезмейка	c	раскалывающая копьезмейка
Раскол	c	раскол
Распространение слизи	c	распространение слизи
Распространитель слизи	c	распространитель слизи
Рвота Зилван	c	рвота зилван
Регенеративная кислота	c	регенеративная кислота
Регенерация муталиска	c	регенерация муталиска
Регенерация таурена-морпеха	c	регенерация таурена-морпеха
Режим «Геллиона» 	c	режим «геллиона»
Режим «Геллитрона»	c	режим «геллитрона»
Режим багги	c	режим багги
Режим боя	c	режим боя
Режим предсказания	c	режим предсказания
Режим робота	c	режим робота
Режим танка	c	режим танка
Рекетный танк - атака	c	рекетный танк - атака
Роевик	c	роевик
Рывок боевого робота	c	рывок боевого робота
Самонаводящаяся змейка - улучшение	c	самонаводящаяся змейка - улучшение
Саранчид	c	саранчид
Светопоглощающее покрытие	c	светопоглощающее покрытие
Сеть	c	сеть
СИ - «Один»	c	си - «один»
Сигнальная ракета	c	сигнальная ракета
Сигнальные ракеты	c	сигнальные ракеты
Система синхронного лечения	c	система синхронного лечения
Сковывающее облако	c	сковывающее облако
Скорость таракана	c	скорость таракана
Скрытень - закопаться	c	скрытень - закопаться
Скрытень - СИ - мутация гидралиска в закопанном состоянии	c	скрытень - си - мутация гидралиска в закопанном состоянии
Слизистая глотка	c	слизистая глотка
Смертоносная слизь	c	смертоносная слизь
Смыкающиеся пластины	c	смыкающиеся пластины
Смятение	c	смятение
Снайперский выстрел - периодический урон	c	снайперский выстрел - периодический урон
Собрать (+100 ед. веспена)	c	собрать (+100 ед. веспена)
Собрать (+100 ед. минералов)	c	собрать (+100 ед. минералов)
Создать иллюзию оракула	c	создать иллюзию оракула
Сокрушительная хватка	c	сокрушительная хватка
Сокрушительный рывок	c	сокрушительный рывок
Сокрушить	c	сокрушить
Спиральные крюки	c	спиральные крюки
Спироциты	c	спироциты
Спонтанное созревание	c	спонтанное созревание
Споры провидения	c	споры провидения
Способность гибрида - конец	c	способность гибрида - конец
Способность гибрида - начало	c	способность гибрида - начало
Стазис	c	стазис
Стрекоза	c	стрекоза
Стремительность	c	стремительность
Телепортация	c	телепортация
Телепортация космической станции Валериана	c	телепортация космической станции валериана
Тест - изучить	c	тест - изучить
Тестовый предмет - ловкость	c	тестовый предмет - ловкость
Тестовый предмет - меткость	c	тестовый предмет - меткость
Тестовый предмет - пси	c	тестовый предмет - пси
Техника из кампании	c	техника из кампании
Токсичная желчь	c	токсичная желчь
Турель умоджанской лаборатории	c	турель умоджанской лаборатории
увеличение дальности	c	увеличение дальности
увеличенное время существования саранчида	c	увеличенное время существования саранчида
увеличенный энергозапас	c	увеличенный энергозапас
удар в прыжке	c	удар в прыжке
удар в прыжке (пассивная способность)	c	удар в прыжке (пассивная способность)
удар щупальцем	c	удар щупальцем
удлиненная плеть	c	удлиненная плеть
удлиненные когти	c	удлиненные когти
удлиненный хобот	c	удлиненный хобот
уклонение рабочего	c	уклонение рабочего
уклонение рабочего - пассивная способность	c	уклонение рабочего - пассивная способность
укрепить обшивку наземной и воздушной техники, уровень 1	c	укрепить обшивку наземной и воздушной техники, уровень 1
укрепить обшивку наземной и воздушной техники, уровень 2	c	укрепить обшивку наземной и воздушной техники, уровень 2
укрепить обшивку наземной и воздушной техники, уровень 3	c	укрепить обшивку наземной и воздушной техники, уровень 3
укрепленный панцирь	c	укрепленный панцирь
улучшение «Гипериона»: «Скачок» 4	c	улучшение «гипериона»: «скачок» 4
улучшение «Гипериона»: уровень 1	c	улучшение «гипериона»: уровень 1
улучшение «Гипериона»: уровень 2	c	улучшение «гипериона»: уровень 2
улучшение «Гипериона»: уровень 3	c	улучшение «гипериона»: уровень 3
улучшение «Гипериона»: уровень 4	c	улучшение «гипериона»: уровень 4
улучшенное закапывание	c	улучшенное закапывание
улучшенное лечение	c	улучшенное лечение
улучшенное перевоплощение	c	улучшенное перевоплощение
улучшенные надзиратели	c	улучшенные надзиратели
улучшенные ползучие стражи	c	улучшенные ползучие стражи
улучшенный митоз	c	улучшенный митоз
улучшенный осмос	c	улучшенный осмос
улучшить вооружение наземной и воздушной техники, уровень 1	c	улучшить вооружение наземной и воздушной техники, уровень 1
улучшить вооружение наземной и воздушной техники, уровень 2	c	улучшить вооружение наземной и воздушной техники, уровень 2
улучшить вооружение наземной и воздушной техники, уровень 3	c	улучшить вооружение наземной и воздушной техники, уровень 3
уничтожение строений	c	уничтожение строений
усиление Керриган	c	усиление керриган
усиление Керриган отключено	c	усиление керриган отключено
усиленная грудная клетка	c	усиленная грудная клетка
усиленная клеточная мембрана	c	усиленная клеточная мембрана
усиленные гланды	c	усиленные гланды
усиленные когти	c	усиленные когти
усиленный панцирь	c	усиленный панцирь
ускоренная трансформация	c	ускоренная трансформация
ускоренное развитие	c	ускоренное развитие
ускоренный метаболизм	c	ускоренный метаболизм
утяжеленные иглы	c	утяжеленные иглы
Фазовый щит	c	фазовый щит
Фонтан слизи	c	фонтан слизи
Фотонная перегрузка	c	фотонная перегрузка
Хитиновый панцирь	c	хитиновый панцирь
Хитиновый щиток	c	хитиновый щиток
Целебные способности	c	целебные способности
Цепная реакция	c	цепная реакция
Цепное переливание	c	цепное переливание
Шаг сквозь тень	c	шаг сквозь тень
Шипастые щупальца	c	шипастые щупальца
Шквал ударов	c	шквал ударов
Щит «Гипериона»	c	щит «гипериона»
Щит воздушной единицы	c	щит воздушной единицы
Щит строения	c	щит строения
Щит фантома	c	щит фантома
Экзоскелет	c	экзоскелет
Экспресс-лечение	c	экспресс-лечение
Экстренное ускорение	c	экстренное ускорение
Электрическое дыхание Зурван	c	электрическое дыхание зурван
Электрическое поле [уровень 1]	c	электрическое поле [уровень 1]
Электрическое поле [уровень 2]	c	электрическое поле [уровень 2]
Электрическое поле [уровень 3]	c	электрическое поле [уровень 3]
Электрическое поле, уровень 4	c	электрическое поле, уровень 4
Энергетический потенциал	c	энергетический потенциал
Энергетический узел пси-разрушителя - вкл.	c	энергетический узел пси-разрушителя - вкл.
Энергетический узел пси-разрушителя - выкл.	c	энергетический узел пси-разрушителя - выкл.
Энергия пилона	c	энергия пилона
Энергопередача	c	энергопередача
Эруптивные споры	c	эруптивные споры
Эффективная добыча веспена	c	эффективная добыча веспена
Эффективная добыча ресурсов	c	эффективная добыча ресурсов
Эффективность способностей	c	эффективность способностей
Эффективные мутации	c	эффективные мутации
Ядовитые когти	c	ядовитые когти
Ядовитые споры	c	ядовитые споры
Ядовитый выстрел	c	ядовитый выстрел
Яйцо изначальных зергов - способность 1	c	яйцо изначальных зергов - способность 1
Ярость	c	ярость
Ясная цель	c	ясная цель
Инкубатор	d	Инкубатор уничтожен
Экстрактор	d	Экстрактор уничтожен
Личинка	d	Личинка уничтожена
Омут рождения	d	Омут рождения уничтожен
Эволюционная камера	d	Эволюционная камера уничтожена
Ползучий споровик	d	Ползучий споровик уничтожен
Логово	d	Логово уничтожено
Улей	d	Улей уничтожен
Пещера ультралисков	d	Пещера ультралисков уничтожена
Рассадник тараканов	d	Рассадник тараканов уничтожен
Шпиль	d	Шпиль уничтожен
Гнездо гиблингов	d	Гнездо гиблингов уничтожено
Пещера гидралисков	d	Пещера гидралисков уничтожена
Яма заразителей	d	Яма заразителей уничтожена
Шпиль величия	d	Шпиль величия уничтожен
Ползучий плеточник	d	Ползучий плеточник уничтожен
Пещера ультралисков	d	Пещера ультралисков уничтожена
Королева Роя	a	королеву
Роевик	a	роевика
Зерглинг	p	зерглингов
Королева Роя	p	королев Роя
Аберрация	p	аберрации
Таракан	p	тараканов
Гиблинг	p	гиблингов
Гидралиск	p	гидралисков
Роевик	p	роевиков
Заразитель	p	заразителей
Ультралиск	p	ультралисков
Королева	p	королев
Муталиск	p	муталисков
Губитель	p	губителей
Инкубатор	a	инкубатор
Экстрактор	a	экстрактор
Личинка	a	личинку
Омут рождения	a	омут рождения
Эволюционная камера	a	эволюционную камеру
Ползучий споровик	a	ползучего споровика
Логово	a	логово
Улей	a	улей
Пещера ультралисков	a	пещеру ультралисков
Рассадник тараканов	a	рассадник тараканов
Шпиль	a	шпиль
Гнездо гиблингов	a	гнездо гиблингов
Пещера гидралисков	a	пещеру гидралисков
Яма заразителей	a	яму заразителей
Ползучий плеточник	a	ползучего плеточника
Шпиль величия	а	шпиль величия
Пещера ультралисков	а	пещеру ультралисков
воин	a	воина
воин	d	воину
воин	g	воина
воин	i	воином
воин	p	воине
наемник	a	наемника
наемник	d	наемнику
наемник	g	наемника
наемник	i	наемником
наемник	p	наемнике
Случайный герой	a	случайного героя
Случайный герой	d	случайному герою
Случайный герой	g	случайного героя
Случайный герой	i	случайным героем
Случайный герой	p	случайном герое
Правая кнопка мыши	a	Правую кнопку мыши
Правая кнопка мыши	d	Правой кнопке мыши
Правая кнопка мыши	g	Правой кнопки мыши
Правая кнопка мыши	i	Правой кнопкой мыши
Правая кнопка мыши	p	Правой кнопке мыши
Левая кнопка мыши	a	Левую кнопку мыши
Левая кнопка мыши	d	Левой кнопке мыши
Левая кнопка мыши	g	Левой кнопки мыши
Левая кнопка мыши	i	Левой кнопкой мыши
Левая кнопка мыши	p	Левой кнопке мыши
Комплект	a	комплект
Комплект	d	комплект
Комплект	g	комплект
Комплект	i	комплект
Комплект	p	комплект
Герой	a	герой
Герой	d	герой
Герой	g	герой
Герой	i	герой
Герой	p	герой
Транспорт	a	транспорт
Транспорт	d	транспорт
Транспорт	g	транспорт
Транспорт	i	транспорт
Транспорт	p	транспорт
Эпический облик	a	эпический облик
Эпический облик	d	эпический облик
Эпический облик	g	эпический облик
Эпический облик	i	эпический облик
Эпический облик	p	эпический облик
Легендарный облик	a	легендарный облик
Легендарный облик	d	легендарный облик
Легендарный облик	g	легендарный облик
Легендарный облик	i	легендарный облик
Легендарный облик	p	легендарный облик
Особый облик	a	особый облик
Особый облик	d	особый облик
Особый облик	g	особый облик
Особый облик	i	особый облик
Особый облик	p	особый облик
Редкий облик	a	редкий облик
Редкий облик	d	редкий облик
Редкий облик	g	редкий облик
Редкий облик	i	редкий облик
Редкий облик	p	редкий облик
Здоровье	a	здоровье

Здоровье	d	здоровью

Здоровье	g	здоровья

Здоровье	i	здоровьем

Здоровье	p	здоровье

Мана	a	ману

Мана	d	мане

Мана	g	маны

Мана	i	маной

Мана	p	мане

Ярость	a	ярость

Ярость	d	ярости

Ярость	g	ярости

Ярость	i	яростью

Ярость	p	ярости

Отвар	a	отвар

Отвар	d	отвару

Отвар	g	отвара

Отвар	i	отваром

Отвар	p	отваре

Энергия	a	энергию

Энергия	d	энергии

Энергия	g	энергии

Энергия	i	энергией

Энергия	p	энергии

Штурмовик	a	штурмовика
Боец	a	боец

Боец	d	боец

Боец	g	боец

Боец	i	боец

Боец	p	боец

Убийца	a	убийца

Убийца	d	убийца

Убийца	g	убийца

Убийца	i	убийца

Убийца	p	убийца

Поддержка	a	поддержка

Поддержка	d	поддержка

Поддержка	g	поддержка

Поддержка	i	поддержка

Поддержка	p	поддержка

Специалист	a	специалист

Специалист	d	специалист

Специалист	g	специалист

Специалист	i	специалист

Специалист	p	специалист

Штурмовик	d	штурмовику

Штурмовик	g	штурмовика

Штурмовик	i	штурмовиком

Штурмовик	p	штурмовике

Зараженный штурмовик	a	зараженного штурмовика

Зараженный штурмовик	d	зараженному штурмовику

Зараженный штурмовик	g	зараженного штурмовика

Зараженный штурмовик	i	зараженным штурмовиком

Зараженный штурмовик	p	зараженном штурмовике